rollno,quiz1,quiz2,midsem,endsem,total-marks
24B041,5,3,24,19,51
24B015,7,10,12,41,70
23B488,6,8,3,36,53
23B457,4,9,15,18,46
23B748,4,2,17,46,69
24B847,4,9,27,29,69
23B702,1,8,14,47,70
23B931,2,7,26,35,70
24B099,1,4,10,18,33
24B094,1,1,5,49,56
23B296,7,10,14,48,79
23B253,4,8,21,5,38
23B315,2,4,6,13,25
23B409,6,6,24,48,84
23B666,10,7,2,45,64
