rollno,quiz1,quiz2,midsem,endsem,total-marks,grades
23B296,7,10,14,48,79,AB
23B409,6,6,24,48,84,AB
23B702,1,8,14,47,70,AB
23B748,4,2,17,46,69,AB
23B931,2,7,26,35,70,AB
23B457,4,9,15,18,46,BB
23B488,6,8,3,36,53,BB
23B666,10,7,2,45,64,BB
23B253,4,8,21,5,38,CC
23B315,2,4,6,13,25,F
